CCCCCCCCCCCCCCCC
CLLLLLLLLLLLLLLL
CLLLLLLLLLLLLLLL
CCCCCCCCCCCCCCCC
CCCCCCCCCCCCCCCC
CAAAAAAAAAAAAAAA
CAAAAAAAAAAAAAAA
CCCCCCCCCCCCCCCC