CCCCCCCCCCCCCCCC
NNNNNNNNNNNNNNNN
NNNNNNNNNNNNNNNN
CCCCCCCCCCCCCCCC
CCCCCCCCCCCCCCCC
LLLLLLLLLLLLLLLL
LLLLLLLLLLLLLLLL
CCCCCCCCCCCCCCCC