CCCCCCCCCCCCCCCC
CNNNNNNNNNNNNNNN
CNNNNNNNNNNNNNNN
CCCCCCCCCCCCCCCC
CCCCCCCCCCCCCCCC
CLLLLLLLLLLLLLLL
CLLLLLLLLLLLLLLL
CCCCCCCCCCCCCCCC